S....X.....X.......
.XXX.X.XXX.X.XXXXX.
.X...X...X:..X.X...
.XXXXXXX.XXX.X.X.XX
...X...X...X...X.X.
XX.X.XXX.X.XXXXX.X.
.....X...X...X.....
.XXXXX.X.XXXXX.XXXX
.......X...X......:
