XXXXXXXXX:XXX
X.......X...X
X.X.XXX.X.X.X
X.X.X...X.X.X
X.X.X.XXX.X.X
X.X.X.X...X.X
XXX.X.XXXXX.X
X...X.X...X.X
X.XXX.X.X.X.X
X...X...X.X.X
X.X.XXXXX.X.X
X.X.X...X.X.X
XXX.X.X.X.X.X
E.X.X.X.X.X.X
X.X.X.XXX.X.X
X.X.X.....X.X
X...X.X...X.X
XXXXX.X.X.X.X
X.......X...X
XXXXXXXXXXXXX
